111111111111111111111111111111111111111111111111
100000000000000000000000000000000000000000000001
102000000000000000000000000000000002000000000001
100000000000000000000000000000000000000000000001
100000000000000000000000000000000000000000000001
100000000000000000000020000000000000000000000001
100000000000000000000000000000000000000000000001
100000000000000000000000000000000000000000000001
100000000000000000000000000000000000000000000001
100000000000000000000000000000000000000000000001
100000000004000000000000000000000000000000000001
100000000000000000000000000000000000000000000001
100000000000000000000000000000000000000000040001
100030000000000000000000000000000000000000000001
100000000000000000000002000000000000000000000001
111111111111111111111111111111111111111111111111
