1111111111111111111100000000000000000011111111111111111111
1000000000000000000100000000000000000010000000000000000001
1000000000020000000100001111111110000010000000000000002001
1000000000000000000111110000000001111110000000000000000001
1000000000000000000000000000000000000000000000000003000001
1000000000000000000111110020000001111110000000000000000001
1000000000000000000100001111111110000010000200000000000001
1000000000000000000100000000000000000010000000000000000001
1111111111111111111100000000000000000011111111111111111111