000000000000000000000000000000000000000000000000000000000
000000000000000000000000000011111111111111111111111111111
000000000000000000000000000010000000000000000000000000001
000000000000000000000000000010000000000000000000000006001
000000000000000000000000000011111111111111111111111111111
