1111111111111111111111111111111111110000000000000000000000000000000000000
1000000000000000000000000000020000010000000000000011111111111111111111111
1020000000000000000000000000000500010000000000000010000000000000000000001
1000000000000000000000000000000000010000000000000010000000000000000000001
1000000000000000000000000000004000010000000000000010000000000000000000001
1000000000000000000000000000000000010000000000000010000022222222222000001
1000000000000000000000000000000000011111111111111110000200000000000200001
1000000000002000000000000000000000000000000100000000002002222022220020001
1000000000000000000000000000000000000000000100000000002002222022220020001
1000000000000000000000000000000000011111111111111110000200000000000200001
1000000000000000000000000000000000010000000000000010000022222222222000701
1000000000000000000000000000000000010000000000000010000000000000000000001
1000000000000000000000000000000000010000000000000011111111111111111111111
1000004000000000000000000020000000010000000000000000000000000000000000000
1000000000000007000000000000000000010000000000000000000000000000000000000
1111111111111111111111111111111111110000000000000000000000000000000000000
